11111111111111111
1P0C0000000000001
1000E000000H10001
1H000000000H1C001
1000C000000H10001
10000M00000H10001
1000000C000H1VVV1
11111111111111111